111111111111
10P000000001
100000000001
100001111001
100001000001
100000000001
111111111111