111111111111111111111111111111111111
110111000101010001110001000101010001
110111010101010101110111010101010111
110111000101010001110111000101010011
110111010101010101110111010101010111
110001010110110101110001010110110001
111111111111111111111111111111111111
1C0000000000000C00001000000000001111
1110010100100E0010100100000001010111
101001001010101000100100000001000111
10000P0C0C00C0000000000000000001C111
111111111111111111111111111111111111