111111111111
100000000001
1000P0C00001
100001111001
1000010C0001
100C00000E01
111111111111