111111111111111111111111111111111
1000000000000PEC00000000000000001
100000000000000000000000000000C01
100000000000000000000000000000C01
111111111111111111111111111111111
111111111111111111111111111111111